ungirded	ungird
forbidden	forbid
knelt	kneel
outsat	outsit
sunk	sink
slung	sling
trodden	tread
sung	sing
slunk	slink
forewent	forego
swam	swim
speeded	speed
overdid	overdo
underbidden	underbid
graved	grave
unladen	unlade
graven	grave
sped	speed
unladed	unlade
sent	send
abode	abide
struck	strike
overdone	overdo
oversewn	oversew
begot	beget
underbought	underbuy
underlaid	underlay
crowed	crow
clothed	clothe
heaved	heave
underlain	underlie
sang	sing
undone	undo
overlain	overlie
dealt	deal
overlaid	overlay
sank	sink
outwore	outwear
winded	wind
withheld	withhold
unhung	unhang
sawed	saw
knitted	knit
strung	string
abided	abide
stood	stand
beaten	beat
unwound	unwind
overshot	overshoot
bestrid	bestride
learned	learn
worked	work
told	tell
led	lead
chose	choose
bespoken	bespeak
drew	draw
unsworn	unswear
dwelled	dwell
met	meet
undershot	undershoot
outdone	outdo
bode	bide
strewn	strew
overseen	oversee
oversold	oversell
partaken	partake
sawn	saw
besought	beseech
brought	bring
shrove	shrive
beheld	behold
oversewed	oversew
forbore	forbear
fed	feed
spoke	speak
would	will
untaught	unteach
upheld	uphold
taken	take
slidden	slide
unlearned	unlearn
foregone	forego
overbuilt	overbuild
meant	mean
broke	break
mowed	mow
known	know
unwove	unweave
woven	weave
wore	wear
worn	wear
upbuilt	upbuild
leaped	leap
alit	alight
withdrew	withdraw
shook	shake
lighted	light
slid	slide
bent	bend
flung	fling
rode	ride
heard	hear
overheard	overhear
sought	seek
bided	bide
stole	steal
overleaped	overleap
chid	chide
waylaid	waylay
swung	swing
untrodden	untread
stricken	strike
foreseen	foresee
swore	swear
sworn	swear
undertook	undertake
overridden	override
misgave	misgive
strove	strive
lay	lie
misgiven	misgive
overtaken	overtake
crept	creep
rove	reeve
swollen	swell
upswept	upsweep
shorn	shear
outrode	outride
unmade	unmake
foresaw	foresee
dreamed	dream
held	hold
shoed	shoe
clave	cleave
overbidden	overbid
wrought	work
tore	tear
outate	outeat
unlearnt	unlearn
betted	bet
chosen	choose
strewed	strew
bestrewn	bestrew
torn	tear
befallen	befall
hewed	hew
crew	crow
retold	retell
hidden	hide
bereft	bereave
outshone	outshine
woken	wake
outbidden	outbid
flew	fly
bound	bind
spelt	spell
fled	fly
unwoven	unweave
overwrote	overwrite
did	do/does
leaned	lean
blest	bless
found	find
went	go
strode	stride
girt	gird
foreran	forerun
taught	teach
hanged	hang
befell	befall
forgot	forget
slew	slay
borne	bear
shown	show
overcame	overcome
laid	lay
shrived	shrive
outlaid	outlay
outdid	outdo
lain	lie
got	get
shriven	shrive
risen	rise
unfroze	unfreeze
bestrewed	bestrew
cloven	cleave
reaved	reave
thrown	throw
ate	eat
misdealt	misdeal
could	can
leapt	leap
alighted	alight
unslung	unsling
fallen	fall
spilt	spill
rang	ring
undid	undo
blown	blow
spoken	speak
oversaw	oversee
done	do/does
awoke	awake
drove	drive
overrode	override
partook	partake
bitten	bite
dwelt	dwell
given	give
swept	sweep
undersold	undersell
caught	catch
slept	sleep
outworn	outwear
begotten	beget
bethought	bethink
misunderstood	misunderstand
took	take
outgrown	outgrow
unlaid	unlay
girded	gird
unsaid	unsay
shrunken	shrink
bidden	bid
grew	grow
overdrove	overdrive
showed	show
unknitted	unknit
overbore	overbear
gotten	get
overborne	overbear
were	be
forbade	forbid
unbuilt	unbuild
ran	run
spelled	spell
underdid	underdo
overran	overrun
rent	rend
seen	see
saw	see
sat	sit
outfought	outfight
clove	cleave
built	build
laden	lade
outthrown	outthrow
foreshowed	foreshow
laded	lade
lit	light
bestrode	bestride
overtook	overtake
ungirt	ungird
cleft	cleave
swelled	swell
unstuck	unstick
knew	know
paid	pay
hamstrung	hamstring
unthought	unthink
eaten	eat
gilt	gild
unspoken	unspeak
bred	breed
blent	blend
fordone	fordo
bade	bid
forsook	forsake
came	come
shot	shoot
outgone	outgo
mistook	mistake
blended	blend
stove	stave
trod	tread
undrew	undraw
shod	shoe
sown	sow
wrung	wring
outridden	outride
ground	grind
gilded	gild
sewn	sew
written	write
should	shall
overdrew	overdraw
overwritten	overwrite
thriven	thrive
forsworn	forswear
thrived	thrive
forswore	forswear
underwritten	underwrite
hid	hide
durst	dare
outshot	outshoot
riven	rive
rived	rive
prechose	prechoose
rung	ring
undrawn	undraw
undergone	undergo
wrote	write
unspoke	unspeak
blew	blow
overdrawn	overdraw
overwound	overwind
bled	bleed
underpaid	underpay
said	say
learnt	learn
shaven	shave
throve	thrive
shaved	shave
outthrew	outthrow
overgrown	overgrow
won	win
drawn	draw
burned	burn
bought	buy
mown	mow
overflew	overfly
smelled	smell
sold	sell
spoiled	spoil
overeaten	overeat
staved	stave
kneeled	kneel
overdriven	overdrive
became	become
forgotten	forget
unreeved	unreeve
quitted	quit
drunk	drink
hewn	hew
underwrote	underwrite
slain	slay
swum	swim
flied	fly
betook	betake
underlay	underlie
withdrawn	withdraw
forecasted	forecast
underdone	underdo
hamstringed	hamstring
smote	smite
uprose	uprise
been	be
dug	dig
drank	drink
unstrung	unstring
rebuilt	rebuild
woke	wake
threw	throw
underran	underrun
reeved	reeve
ridden	ride
overblew	overblow
ridded	rid
foreknew	foreknow
arisen	arise
stolen	steal
waked	wake
frozen	freeze
might	may
uprisen	uprise
melted	melt
melten	melt
bespoke	bespeak
upswung	upswing
leant	lean
overspent	overspend
outspent	outspend
reft	reave
weighed	weigh
outran	outrun
grown	grow
began	begin
wound	wind
stridden	stride
inlaid	inlay
prechosen	prechoose
clung	cling
driven	drive
bestridden	bestride
flown	fly
arose	arise
overthrew	overthrow
kept	keep
spent	spend
dared	dare
thought	think
undertaken	undertake
mislaid	mislay
left	leave
-	will
forsaken	forsake
mistaken	mistake
overflown	overfly
foreshown	foreshow
sweated	sweat
outbred	outbreed
overfed	overfeed
sprang	spring
chided	chide
rose	rise
had	have
underfed	underfeed
overbought	overbuy
fordid	fordo
gave	give
stunk	stink
stung	sting
awaked	awake
dreamt	dream
bit	bite
burnt	burn
overate	overeat
overthrown	overthrow
sheared	shear
broadcasted	broadcast
lost	lose
clad	clothe
overgrew	overgrow
misled	mislead
hung	hang
overslept	oversleep
overleapt	overleap
overhung	overhang
born	bear
unrove	unreeve
bore	bear
outgrew	outgrow
overlay	overlie
shone	shine
sowed	sow
wetted	wet
forgiven	forgive
unswore	unswear
sprung	spring
unfrozen	unfreeze
broken	break
relaid	relay
shaken	shake
wept	weep
outbade	outbid
spilled	spill
foretold	foretell
beseeched	beseech
forgave	forgive
stank	stink
wedded	wed
strid	stride
froze	freeze
lied	lie
blessed	bless
repaid	repay
striven	strive
strived	strive
overblown	overblow
forbad	forbid
stuck	stick
gainsaid	gainsay
fought	fight
underwent	undergo
was	be
spat	spit
overpaid	overpay
forborne	forbear
made	make
understood	understand
spun	spin
shrunk	shrink
foreknown	foreknow
outeaten	outeat
browbeaten	browbeat
wist	wit
gone	go
proved	prove
begun	begin
shined	shine
proven	prove
wove	weave
smelt	smell
sunken	sink
betaken	betake
hove	heave
withstood	withstand
spoilt	spoil
outsold	outsell
smitten	smite
shredded	shred
felt	feel
untrod	untread
cleaved	cleave
overladen	overlade
fell	fall
shrank	shrink
unbent	unbend
lent	lend
unbound	unbind
overladed	overlade
died	die
sewed	sew
outwent	outgo
chidden	chide
bereaved	bereave
